█████████████████████████████████████████████████████████████████████████████
█     █   █       █           █ █ █     █ █     █   █ █ █   █     █   █   █ █
█ ███ █ ███ █████████ █████ ███ █ ███ ███ █ █████ ███ █ ███ █ ███ ███ █ ███ █
█ █     █   █ █         █       █     █   █ █         █ █       █ █       █ █
█████ █ █ █ █ █ █████ █ █████ ███████ █ █ █ █ █ ███████ █ ███ █████ █████ █ █
█     █ █ █   █ █ █   █ █   █ █ █       █ █ █ █   █ █ █ █ █ █ █ █       █   █
█ █ ███ █ ███ ███ ███ ███ █████ █ ███ █████ ███ ███ █ █ ███ █ █ █ ███████████
█ █   █   █ █   █   █   █       █ █   █   █     █ █     █           █ █ █   █
█ █ ███ ███ ███ ███ █ ███ █ █████████ ███ ███ █ █ █ █████ ███████████ █ █ █ █
█ █ █   █               █ █     █ █ █   █     █         █     █ █       █ █ █
█ ███ █████ ███ █ █ ███ █ █ ███ █ █ ███ ███ █ ███████████ █ ███ █████ ███ █ █
█   █ █   █   █ █ █   █   █   █         █ █ █   █ █ █ █ █ █       █     █ █ █
███ ███ █ ███████ █ █████████ ███ ███████ ███ ███ █ █ █ █ █████████ ███████ █
█     █ █         █   █     █ █   █   █ █                 █   █         █   █
███ █ █ ███ ███████ █████ █ █ ███ █ ███ █ ███ ███ █████ ███ ███ █████ █████ █
█   █ █ █     █   █       █ █   █       █   █ █     █ █ █   █   █     █     █
█████████████████ ███ █ █ ███ █████████ █ ███ █████ █ █ █ ███████ █ █ █ ███ █
█ █ █     █ █ █ █ █   █ █ █ █   █ █ █ █ █ █ █ █   █   █     █     █ █ █   █ █
█ █ █████ █ █ █ █ █ ███████ █ ███ █ █ █ ███ █ █ █ ███ █████ ███████ ███ ███ █
█ █                 █   █           █   █     █ █ █   █     █ █   █ █ █ █ █ █
█ █████ ███ █ ███ ███ ███ █████ ███ ███ █ ███████ █ ███████ █ ███ █ █ ███ █ █
█         █ █   █   █         █   █ █ █   █     █ █ █   █         █ █       █
█ █ ███ █████ █ █████ █████ █ █ ███ █ █ █ ███ █ █ ███ █████████████ ███████ █
█ █   █   █   █   █ █ █ █ █ █ █ █   █   █   █ █     █     █ █ █         █   █
█ █ ███ ███████ █ █ █ █ █ █ █████████ █████████ ███ █████ █ █ █ █ █ █████ ███
█ █   █ █     █ █ █   █     █       █           █ █   █ █       █ █ █   █ █ █
███ █ █████ █████████████ █████ █ ███ █████████ █ █ █ █ ███ █ █ █ ███ █ █ █ █
█ █ █       █   █     █ █     █ █   █   █     █   █ █ █ █   █ █ █ █   █     █
█ █████ █ █ █ █████ ███ ███ ███ █████ ███ ███ █████ ███ █ ███████ ███ ███████
█       █ █   █         █ █ █   █       █   █ █   █ █   █ █       █     █ █ █
█████ █ █████ █████ █ ███ █████ █ ███ █████ █████ █ ███ ███ █ ███████ █ █ █ █
█ █ █ █     █ █     █     █       █ █     █     █           █   █     █     █
█ █ █ ███ █ ███ ███ ███ █ █ ███ ███ ███ █ █ █ █ █ █ █████████ █ █ ███████ ███
█ █ █   █ █ █ █ █     █ █   █   █   █   █ █ █ █ █ █ █ █ █     █ █   █   █   █
█ █ █ █████ █ █████ ███████ █ █ █ ███ █ ███████ ███ █ █ █ █████ █ █████ █ ███
█       █     █ █       █ █ █ █     █ █     █       █     █   █       █     █
█ █ ███ ███ ███ ███ █ ███ ███ █████ ███████ ███████ █ ███ ███ ███ █ █ █████ █
█ █ █     █ █ █     █ █   █ █     █       █ █       █ █ █       █ █ █ █     █
███████ ███ █ ███████ ███ █ ███ ███ ███ ███ █████ █ ███ ███ ███ █████ ███ █ █
█ █     █       █   █   █   █   █   █   █   █     █ █         █ █     █   █ █
█ █████ █████ ███ █ ███████ ███ █ ███ █████ █ █ ███ ███ █ █ ███ █ █ █ █████ █
█         █     █ █ █         █ █   █     █ █ █ █   █   █ █   █ █ █ █ █     █
███ █████████ ███ ███████ ███████████ █████ ███ ███ █ █ █████████ ███ ███ ███
█   █ █ █   █       █   █   █     █       █ █ █ █ █ █ █ █ █       █ █   █   █
█████ █ █ ███ ███████ █ █ ███ ███ █ ███ ███ █ ███ ███ ███ █████ ███ █ ███████
█           █   █   █ █         █     █ █ █ █ █ █   █ █     █     █ █       █
█ ███ █ ███ █████ █████ ███ ███ █ ███ ███ █ █ █ ███ █ ███ █ █ ███ █ █ █ █ ███
█   █ █ █       █   █ █ █ █   █ █   █   █ █ █ █       █   █     █ █   █ █ █ █
█ █ █ █ ███████ █ █ █ ███ ███████ ███ ███ ███ ███ █████████████████ █ █ █ █ █
█ █ █ █ █     █   █       █         █ █ █ █     █ █ █   █     █   █ █ █ █   █
█ █ █ █████ ███ █████████ █ ███ ███ ███ █ █ ███ ███ ███ ███ █ █ █████ █ ███ █
█ █ █   █   █   █           █     █   █     █ █ █ █ █   █ █ █         █   █ █
███████████ █ █ ███████ █ ███████ ███ █████ █ █ █ █ █ ███ █████ ███ ███████ █
█ █   █       █ █       █ █   █ █ █ █         █   █   █       █   █       █ █
█ ███ █████████ █████████████ █ █ █ ███████ █████ █ ███ █████ █████ ███ ███ █
█   █ █ █ █     █ █   █ █   █     █   █ █     █     █ █ █           █   █ █ █
█ ███ █ █ ███████ █ ███ ███ █████ █ ███ █ █ █████ ███ █ ███ ███ █ ███ ███ ███
█     █     █     █   █   █           █   █ █         █   █ █   █   █   █   █
█ █ █ █████ ███ █ ███ █ █ █ █████ █ █ ███ █ ███ ███████████████ █ █████████ █
  █ █     █     █       █ █ █     █ █   █ █ █       █       █   █ █   █     █
█ █████████████████ ███ █████ ███ █████ ███████████ ███ ███ █████████ █ ███ █
█ █ █   █     █     █           █ █   █ █     █       █ █       █   █   █ █ █
█ █ ███ █ █████ ███ ███████████ ███ ███ █████ █ ███ ███ ███ █ █ █ █ ███ █ ███
█       █       █   █   █ █   █   █     █ █ █     █       █ █ █   █       █ █
█████ █ █ █ █ ███ ███ ███ █ █████████ █ █ █ █ █ █████████ ███ ███████ █ ███ █
█   █ █   █ █ █ █   █       █     █ █ █   █ █ █   █       █   █     █ █     █
█ ███ █████████ ███ █████ █ ███ █ █ █████ █ █████████████ █ ███ ███████ █████
█ █     █ █   █ █   █ █ █ █   █ █     █         █ █ █     █     █   █       █
█ █ █ █ █ █ █ █ █ ███ █ █ █ ███ █ █ █ █ ███ █ ███ █ █ ███ █ █ ███ ███████████
█   █ █ █   █ █ █ █       █     █ █ █   █   █   █ █     █ █ █ █     █ █     █
█ █ ███████ ███ █████ ███ █ █ █ █████ █ █████████ █████ █████ █ █ ███ █ █ ███
█ █     █     █   █     █ █ █ █   █ █ █ █     █ █   █ █   █ █ █ █ █   █ █   █
█ █ █ █ ███ █ ███ ███████ ███████ █ █ ███ █ ███ █ █ █ █████ █ ███ ███ ███ █ █
█ █ █ █ █   █         █     █       █   █ █     █ █             █         █ █
█ █ ███████ █ ███████ █ █ ███ █ ███ ███ █ █████ ███ █ ███ █ ███ █ ███ █ ███ █
█ █   █     █   █       █ █   █ █   █   █   █       █   █ █   █     █ █ █   █
█████████████████ ███████████████████████████████████████████████████████████
