███████████████████████████████████████████████████████████████████████████████████████
█                 █   █       █ █ █     █     █     █ █ █   █     █     █     █ █ █ █ █
███████ ███ █████ █ █ █ █████ █ █ █ ███████ ███████ █ █ ███ ███ █ █████ █ █████ █ █ █ █
█         █   █     █   █   █         █       █   █ █ █ █       █       █   █       █ █
█ █ ███ ███ █ ███████ █ █ ███ █ █ ███████ ███ █ ███ █ █ ███ ███ ███ █ █████ ███████ █ █
█ █   █   █ █       █ █ █ █   █ █     █     █ █         █   █     █ █   █   █   █ █   █
█ ███ █ █ █ ███ █ ███ ███ █████████████ █ █ ███ █████ ███ ███ █ █████ █ █ ███ ███ ███ █
█   █ █ █ █ █ █ █ █       █     █   █ █ █ █ █ █   █       █ █ █ █ █ █ █ █       █     █
█████ █ ███ █ █ ███ █ ███ █ █ ███ █ █ █████ █ █████████ ███ █████ █ █ █████ ███ █ █ ███
█     █ █   █   █ █ █ █   █ █ █   █     █ █   █                 █ █     █ █ █   █ █   █
█████ █████ █████ █ █████ █ ███ █ ███ ███ █ █████ ███████ ███████ █████ █ █████ ███ █ █
  █       █   █ █   █       █   █ █ █ █     █     █   █ █     █         █ █ █   █   █ █
█ █ ███ ███ ███ █ █ █ █████ █ ███ █ ███ ███████████ █ █ ███████ ███ █ █ █ █ █ █ ███ █ █
█   █   █   █   █ █ █   █ █   █             █   █ █ █     █       █ █ █   █   █     █ █
█ █████████████ █████ ███ █████████████ ███ █ ███ █████ █ █████ ███ █████████ █ █████ █
█     █     █   █ █   █   █   █     █   █ █     █       █ █     █     █     █ █ █ █   █
███ █ █ ███ █ █ █ ███ ███ █ ███████ ███ █ █ █ ███ ███████████████ █████ ███ ███ █ ███ █
█ █ █ █   █   █ █           █ █         █ █ █     █ █   █             █   █ █       █ █
█ █████ █████ ███ █ ███████ █ █████ ███ █ █ █ █ █ █ ███ █████████ ███ █ █████ █ █████ █
█   █ █ █ █ █   █ █ █ █   █   █ █ █   █ █ █ █ █ █ █   █ █ █ █     █ █     █   █   █ █ █
███ █ █ █ █ █████ ███ █ ███ ███ █ ███████ ███ ███ █ ███ █ █ ███████ █ ███ █ █ ███ █ ███
█     █ █       █         █ █   █ █   █   █ █   █   █ █     █           █   █   █   █ █
█ ███ █ █ █████ █ █ █████ █████ █ █ █ █ █ █ ███ █ ███ █ █ █████ ███ █████ █ █████ ███ █
█ █   █   █     █ █   █       █   █ █   █   █   █       █ █   █ █   █ █ █ █     █ █   █
█ █ █ ███ █ ███ █ █████ █ ███████ █ █████ ███████████████ █ █ ███ ███ █ █████ ███ █ █ █
█ █ █   █ █ █       █ █ █   █   █       █ █     █           █     █ █     █     █   █ █
███ █ █ ███████ █████ █████████ █ █ █████████ █ ███ ███████ █████ █ ███ █ ███ ███ █████
█   █ █               █ █   █   █ █ █   █ █ █ █ █ █ █     █     █     █ █     █     █ █
█████████ ███████ █████ █ █████ █ ███ █ █ █ █ ███ ███ █████ █████ ███████ ███████ ███ █
█   █       █ █                 █     █ █   █ █ █   █   █   █     █   █ █   █   █   █ █
█ █ █ ███████ ███ █████ █ █ █ █████ ███████ █ █ █ █ █ █ █████ █ █ ███ █ ███ ███ █ █ █ █
█ █       █ █       █ █ █ █ █                   █ █   █     █ █ █   █   █       █ █   █
███████ ███ █ █ █████ ███████ ███ █ █ █████ █ ███ █ █ █ ███████ █████ █ █ ███████ █████
█   █   █     █   █   █ █ █ █   █ █ █   █   █   █ █ █ █       █ █     █       █     █ █
█ █████ ███ ███ ███ █ █ █ █ █ ███ █ █ █████████████ █████ █ ███ █████ █ ███ █ ███████ █
█ █ █   █   █       █     █   █   █ █     █ █   █   █ █   █     █     █ █   █         █
█ █ █ █████████ █ █ █ █████ ███████ ███████ █ █ ███ █ █████ ███ █ █ █ ███ █ ███████████
█ █   █         █ █ █ █ █ █ █   █ █       █ █ █   █     █   █   █ █ █   █ █     █ █   █
█ █ ███ █████ ███ ███ █ █ █ █ ███ █████ █ █ █ ███████ ███████ ███████████ ███ ███ ███ █
█ █ █       █ █     █   █   █     █     █ █     █     █ █ █   █       █   █ █ █     █ █
█ █ ███ ███ ███ █ █ █████████ ███ ███ ███ ███ █ █ █████ █ ███ █████ ███████ █████ ███ █
█   █ █ █   █   █ █         █   █ █ █ █   █   █ █ █       █ █             █   █ █     █
█████ █ ███████ █████ ███████ ███ █ ███ █ ███ █ █ ███████ █ █ █████ ███ █ ███ █ █ █████
█ █         █ █   █ █   █       █     █ █     █ █ █ █       █   █     █ █     █ █     █
█ █████████ █ █████ ███ ███████ █ █████ █ █ █ █ █ █ ███ █████████████ █ █ █████ █ ███ █
█   █     █   █   █   █         █ █ █ █ █ █ █ █ █ █   █   █   █ █ █   █ █     █ █   █ █
█ █████ ███ ███ █ █ █ ███ █████████ █ █ █████████████ ███ ███ █ █ █ █ █ ███ ███ █ ███ █
█ █   █   █ █   █ █ █ █               █ █             █ █     █ █   █ █ █ █     █   █ █
█ █ ███ █ █ █████ ███ ███ ███ ███ █ ███ █████ ███████ █ █ ███ █ █ ███ ███ █████ ███ ███
█       █     █   █         █ █ █ █ █     █   █ █   █       █ █ █   █     █ █   █     █
█████ █████████ ███ ███ █ █ █ █ █ █ ███████████ █ █████ ███ ███ █ ███████ █ ███████ █ █
█         █ █ █   █ █ █ █ █ █ █   █ █ █           █       █     █       █   █     █ █ █
█████ █ ███ █ █ ███ █ ███████ ███ █ █ ███ █ █ █ █ ███████ ███████ █████████ █████ █ ███
█     █           █       █ █   █ █       █ █ █ █     █     █     █   █       █       █
███ █ ███ ███ ███ █████████ █████ █ ███ ███████ █████ █ █ █████████ ███ █████ █████ █ █
█   █ █     █   █   █   █   █ █ █ █   █ █ █ █ █ █ █ █   █ █ █     █       █         █ █
█ ███████ ███ █ █ █ ███ ███ █ █ █ █ █ ███ █ █ ███ █ ███ ███ █ ███ █ █ ███ ███ ███ █ █ █
█ █       █ █ █ █ █     █ █   █   █ █ █ █             █   █     █   █ █ █ █   █   █ █ █
█ █████ ███ ███████ █████ █ █ █████ █ █ █████ ███ █████ █ ███ █ ███ ███ █████ █ █ █████
█ █   █ █   █ █ █ █   █ █   █ █     █   █   █ █ █   █   █ █   █ █         █ █ █ █   █ █
█████ █ █ ███ █ █ █ ███ ███ █████ █ █████ █ █ █ █ █████████ █ █████████████ █ █████ █ █
█       █ █               █ █   █ █     █ █ █   █ █ █ █   █ █               █ █   █   █
█ ███ ███ ███████ █ ███ ███ ███ █ ███ ███ ███ ███ █ █ ███ █ ███ █████ █ █ █ █████ █████
█ █     █ █ █ █   █ █ █     █     █   █ █   █ █   █   █   █ █       █ █ █ █ █   █     █
███ █ ███ █ █ █ █████ █ █ █ █ █████████ █ █ █████ ███ █ █ █ ███ ███ ███████ █ █ ███ ███
█   █ █   █ █   █     █ █ █ █ █ █     █   █ █   █   █   █     █   █   █ █     █   █ █ █
█████ █ ███ ███████ ███ ███████ ███ ███ █ █ ███ ███ █ █ █████ █████ ███ ███ █████ █ █ █
█           █     █ █         █         █ █ █         █ █       █ █ █       █   █     █
█████ ███ █████ ███ █ █ █ █ █████ █████████ █████████ ███████ ███ ███ █████ █ █ █ █████
█ █     █   █     █   █ █ █ █ █     █             █   █ █   █   █   █     █ █ █       █
█ █ ███ █████ ███████ █████ █ █ ███████████████████ ███ ███ ███████ █ █████ █████ ███ █
█   █ █       █   █   █   █ █       █           █     █           █   █ █     █ █ █   █
█████ █ ███ █ █ █ █ ███ █ ███ █████ █ █████ █ █ █ █████ █████ █████ █ █ ███████ ███ ███
█ █ █ █   █ █ █ █ █ █   █   █     █ █   █   █ █ █       █     █ █   █             █ █ █
█ █ █ █████ █ ███ █████ █ ███ █████ █ ███ ███ █ ███████ █ █ ███ █ ███ █████████ █████ █
█       █   █       █   █ █ █     █     █   █ █ █ █     █ █     █ █ █ █   █   █       █
█ █ ███ ███████ █████ █ ███ █ █ █ ███████ ███ █ █ █████ █████ ███ █ █ █ █████ █████ ███
█ █ █   █ █           █ █     █ █ █         █ █ █       █     █ █ █ █     █         █ █
█ █████ █ █████ █ █ ███ █ █ ███ ███████████████ █ █████ ███ ███ ███ █ █████████ █ █ █ █
█ █   █         █ █   █   █   █   █ █ █       █ █   █   █     █             █ █ █ █   █
█ █ █████ █ █ █████████ █████ █ ███ █ ███ ███ █ █████████ █ █ █ █ █ █████ ███ █ █ ███ █
█ █ █     █ █ █   █     █ █   █ █   █ █ █   █   █         █ █ █ █ █   █ █   █   █ █ █ █
███ █ ███ █ ███ █████ █ █ ███ █ █ ███ █ █ █████ ███ ███ █████ █ █ █ ███ █████ █████ █ █
█     █ █ █ █ █     █ █   █   █     █   █ █       █ █     █ █ █ █ █       █   █     █ █
█ ███ █ █ █ █ █ ███ █████ █ █████ ███ ███ █ █████████ █████ █ █ ███ █ █ █████ █ ███████
█ █   █   █     █   █     █   █         █ █ █               █ █ █   █ █ █             █
█████████████████████████████████████████████████████████████████████████████ █████████
